##################################    #####################################
#                                                           #
#                                                           #
                                                       #    #
                                                       ##
#                                                       #	
#                                                                    
#                                                            #
#############    ######################    ##########################

